+++++++++++++++++++++++++++++++++++++++++++++++++++++++++++++++++++++
+                                                                   +
+       0                                                           +
+                                                                   +
+                                                                   +
+    aaaaaaaaaaaaaaaaaaaaaaaaaaaaaaaaaaaaaaaaaaaaaaaaaaaaaaaaaaaa   +
+                                                                   +
+                                                                   +
+                                                                   +
+                                                                   +
+                                                                   +
+                                                                   +
+                                                                   +
+                                                                   +
+                                                                   +
+                                                                   +
+                                                                   +
+                                                                   +
+                                                                   +
+        ++++++++++++++++                                           +
+                                           +                       +
+                                                                   +
+                                                                   +
+                                                                   +
+                                                                   +
+                                                                   +
+                                                                   +
+                                                                   +
+                                                                   +
+                                                                   +
+          +                  +                                     +
+                                                                   +
+                                                                   +
+                                                                   +
+                                                                   +
+                                                                   +
+                                                                   +
+                                                                   +
+                                                                   +
+                                                                   +
+                                                                   +
+                                                                   +
+                                                                   +
+                                                                   +
+                                                                   +
+                                                                   +
+                                                                   +
+                                                   +               +
+                                                                   +
+                                                                   +
+                                                                   +
+                                        +                          +
+                        ++++++++++++                               +
+                                                                   +
+          +                                                        +
+                                                                   +
+                                                                   +
+                                                                   +
+                                                                   +
+    AAAAAAAAAAAAAAAAAAAAAAAAAAAAAAAAAAAAAAAAAAAAAAAAAAAAAAAAAAAA   +
+                                                                   +
+                                                                   +
+                                                                   +
+                                                                   +
+                                                                   +
+                                                                   +
+                                                                   +
+                                                                   +
+++++++++++++++++++++++++++++++++++++++++++++++++++++++++++++++++++++
