 ++++++++++
 +        +
++ ++++++ +
+0A  +   b+
+    +    +
+    +    +
+    +    +
+ B  +   a+
+++ +++ +++
  + + + +
  +     +
  +++++++
