++++++++++++++++++++++++++++++++++++++++++++
+ 0                                        +
+                                      A   +
+                                          +
+ ++++++++++++++++++++++++++++++++++++++++++
+                                          +
+                                          +
+                                          +
+                                          +
+                                          +
+                                          +
+                                          +
+                                          +
+                                          +
+                                          +
+   a                                      +
++++++++++++++++++++++++++++++++++++++++++++
