+++++      +++++++
+C  ++++++++    A+
+    a b c      B+
+   ++++++++    0+
+++++      +++++++