+++++      +++++++
+B  ++++++++    A+
+   a      b     +
+   ++++++++    0+
+++++      +++++++