+++++       +++++
+C  +++++++++  A+
+D   a b c d   B+
+   +++++++++  0+
+++++       +++++