+++++ +++++
+F  +++   +
+   ab  AB+
+   +++  D+
++g++ ++c++
 +h+   +d+
++ ++ ++ ++
+   +++  H+
+ 0 ef   C+
+   +++ GE+
+++++ +++++
