blue: 0,A
red: 1,B
+++++++++
+A ab  B+
+++++++++
+0     1+
+++++++++