+++++++++++++++++++++++++
+  c   B                +
+           +           +
+  C     b  +           +
+          0+           +
+ +++++++++++++++++++++ +
+           +           +
+           +           +
+        e  +           +
+           +           +
+     E     +           +
+++++++++++++++++++++++++
