++++++++++++++
+ + B A z y+++
+Z++++++++ +++
+  Y+ ABBA +++
+++X+ ++++++++
+V W+ +++AAAB+
+U+++  0+BBUV+
+ +xu   +WXYZ+
+a+wv   ++++++
+ +++++ ++++++
+b ab + ++++++
+++++ + ++++++
+a  b + ++++++
+ +++++ ++++++
+       ++++++
++++++++++++++
