++++++++++++++
+c+  a    b+++
+ ++++++++ +++
+   +      +++
+++ + ++++++++
+   + ++++++++
+ +++  0 A++++
+ +C      ++++
+ +D     B++++
+ +++++ ++++++
+d    + ++++++
+++++ + ++++++
+     + ++++++
+ +++++ ++++++
+       ++++++
++++++++++++++
