+++++++++
+ +++++++
+a+++++++++
+ +++++C  +
+c ac +A  +
+++++ +C  +
+a  c +A  +
+ +++++C  +
+ +++++A  +
+        0+
+++++++++++