red: 1,B
++++   ++++
+ 0+   + a+
+ A+++++  +
+         +
+ B+++++  +
+ 1+   + b+
++++   ++++
