red: A,7
blue: B,0
green: C,2
yellow: D,5
+++++++++++++++
+++++++A+++++++
+++++++a+++++++
+++++++0+++++++
+++++++1+++++++
+++++++ +++++++
+++++++ +++++++
+Bb23     45cC+
+++++++ +++++++
+++++++ +++++++
+++++++6+++++++
+++++++7+++++++
+++++++d+++++++
+++++++D+++++++
+++++++++++++++
