red: 0,A,B
blue: 1,4,C,D
cyan: 2,E
magenta: 3,F
+++++++++++
+CF0   1EA+
+++++ +++++
+2 D+ +B 3+
+  f+ +e  +
+ +++ +++ +
+         +
+++++ +++++
+A+ab cd+4+
+++++++++++
