red: 0,2,4,6,A
blue: 1,3,5,B
+++++++++++++++++++++++++++
+   0++AAABBB+aa++++bbbaaa+
+ +++++AA++BB+aa++++bb++aa+
+ b  B+ 2++3 +aa++++ 5++6 +
++++ ++aa++bb+AA++++BB++AA+
+aA  1+aaabbb+4AAAA+BBBAAA+
+++++++++++++++++++++++++++
