++++++++++++++++++++++++++++
+A    ++++A A              +
+ ++ A    AAa+++++++++++++ +
+     A   + A+             +
++A+ +++  + ++ +++++++++++++
++ +aaaaaa+ a+             +
++ +Aaaa+ +  +++++++++++++ +
+a  +aaaaa A +             +
+   +aaa  A0 + +++++++++++++
+ A +  +++   +             +
+ A +++ A    +++++++++++++ +
+ + A      A +AA           +
+ +++++A     +++++++++++++++
++++++++++++++
