+++++++++++++++++++
+b0AAAAAAAAAAAAAAA+
+AAAAAAAAAAAAAAAAA+
+AAAAAAAAAAAAAAAAA+
+AAAAAAAAAAAAAAAAA+
+AAAAAAAAAAAAAAAAA+
+AAAAAAAAAAAAAAAAA+
+AAAAAAAAAAAAAAAAA+
+AAAAAAAAAAAAAAAAA+
+AAAAAAAAAAAAAAAAA+
+AAAAAAAAAAAAAAAAA+
+AAAAAAAAAAAAAAAAA+
+AAAAAAAAAAAAAAAAA+
+AAAAAAAAAAAAAAAAA+
+AAAAAAAAAAAAAAAAA+
+AAAAAAAAAAAAAAAAA+
+AAAAAAAAAAAAAAAAA+
+AAAAAAAAAAAAAAAAA+
+AAAAAAAAAAAAAAAAB+
+++++++++++++++++++
