+++++++++++++++++
+OsoN jou rn er +
+A  O0 RTS     R+
+  hard     E  H+
+  S    O     R +
+G    T   R     +
+A  F  J  strong+
+     I        N+
+   S   A    U  +
+fast           +
+         D   ai+
+++++++++++++++++
