++++++++++++++++++++++++++++++
+0     A    a      ++A++  a  +
+    ++A++ +a+++++   A    a  +
++++++++++++++++++++++++++++ +
+ a  ++A++ +++++a+   A       +
+ a    A        a  ++A++     +
+ ++++++++++++++++++++++++++++
+      A    a      ++A++  a  +
+    ++A++ +a+++++   A    a  +
++++++++++++++++++++++++++++ +
+a   ++A++ +++++a+   A       +
+a     A        a  ++A++     +
++++++++++++++++++++++++++++++
