++++++++++++++++++++++++++
+ abcdefghijk+lmopqrstuv +
+ ++++++++++++++++++++++ +
+             0          +
+ ++++++++        ++++++ +
+ ++++++++++++++++++++++ +
+ ABCDEFGHIJK+LMOPQRTSUV +
++++++++++++++++++++++++++
