+++++++++++++
+   A 0 B   +
+ +++++++++ +
+ +cb   ad+ +
+ ++++ ++++ +
+ ++++ ++++ +
+    C D    +
+++ +++++ +++
  +++   +++
