red: 0,A
blue: 1,B
++++++++++
+a+++++ A+
+b+ 10   +
+B  ++++ +
++++++++++