red: 0,A,B,C,D
blue: 1,E,F,G,H
cyan: 2,I,J,K,L
magenta: 3,M,N,O,P
++++++++++++++++++++++
+0B D j l     n p2F H+
+A C i k     m o E G +
+++++++++ ++ +++++++++
     +          +         
     +          +         
+++++++++ ++ +++++++++
+ N P f h     a c I K+
+M O1e g     b d J L3+
++++++++++++++++++++++