blue: 4,A,B,C
red: 1,2,I,J,K,L
green: 3,5,6,7,M,N,P,Q,R,S
cyan: 8,U
magenta: 9,T
              ++++++++++++++++++++++++++++++++++++++++++++++++++++++       
        ++++++                                                      ++     
   +++++                                                              ++   
+++                                                                     ++ 
+                               M                                         +
+        +              +       +               +     +   ++              +
+  ++++  +N             +       +               +     +                   +
+ +    +++++  +  +   ++++ +   + ++++  +  +   ++++  ++++ +++   L+++   +++  +
+ +      +    +  +  +   + +   + ++  + +  +  +   + +   +   +   +   + +     +
+  +++   +    +  +  +   + +  +  +   + +  +  +   + +   +   +   +++++ ++    +
+     +  +    +  +  +   +  + +  + 0 + +  +  +   + +   +   +   +       ++  +
+    K+  +    + J+  +  ++  ++   +   + +I +  +  ++ +  ++   +   ++       +  +
+ ++++   +++  ++++   ++ +   +   ++++  ++++   ++ +  ++ + ++++   ++++ +++   +
+                          +                                              +
+                        +++                                              +
+                                                                         +
+                                                                         +
+                                                                         +
+                                                                         +
+                                                                         +
+                                                                         +
+                                                                         +
+++++++++++++                                                             +
+tT8     9Uu+                                                             +
++++++ ++++++                                                            ++
+++++++++++++++++++++++++                                               + +
+             +         +                                             ++  +
+ +i+ + + + + + + + + + +                                            +    +
+             +         +                                           +     +
+ + + + + + + + + + + + +           123                            +      +
+             +         +                                         +    S  +
+ + + + + + + + + + + + +                                        +   R    +
+           k           +                                       +         +
+ + + + + + + + + + + + +                                     ++          +
+     j   +   +         +                                    +            +
+ + + + + +++++ + + + + +                                   +     7    q  +
+         +             +                                  ++        p    +
+ + +++++++ + + + + + + +                                    ++           +
+         +             +                                      ++         +
+ + + + + + + + + + + + +                                        ++       +
+         +           n +                                          ++     +
+ + + + + + + + + + + + +                                            ++   +
+         +         m                                                  ++ +
+++++++++++++++++++++++++                                               + +
+   ++++++                                                              + +
+         ++++++                                                        + +
+               +++                                                     + +
+                  +                                                    + +
+       6           +                                                   + +
+    5         s     +                                                  + +
+        Q            +                                                 + +
+     P      r         +                                                + +
+                       +                                               + +
+++++++++++++++++++++++  +                                             +  +
                      +  ++                                          ++   +
 +++++++++++++++++++   +  +                                       +++    ++
 +     +         +A+   +  +                                    +++    +++  
 + +++ + +++++ + + +    +  +                                +++    +++     
 + +b  + + +   +   +    +  +                             +++    +++        
 + +++++ + + +++++++     +  +                         +++    +++           
 +       + +       +     +  +                 ++   +++     ++              
 + +++++++ +++++++ +      +  +                +l ++     +++                
 + +   +         + +      +  +                +++    +++                   
 + + + + + +++++ + +       +  +            +++    +++                      
 + + + + + +  C+ + +       +  +         +++    +++                         
 + + + +++ + +++ +4+        +  +     +++    +++                            
 +   +     + +   +c+        +  +  +++    +++                               
 +++++++++++ + +++++         +  ++    +++                                  
 + +         + +   +         +     +++                                     
 + + + +++++ + + + +          +  ++                                        
 +   + +     + +B+ +          +++                                          
 + +++ +++++++ +++ +                                                       
 +  a+             +                                                       
 +++++++++++++++++++                                                       