++++++++++
+AAAA+++++
+A++A+++++
+A++    ++
+a++ 0  ++
++++++++++
