+++++++++++++++++++
+0                +
+              ++++
+                 +
+              ++A+
+               +a+
+++++++++++++++++++
