+++++++++++++++++++
+ A               +
+           0  ++++
+    A            +
+              ++A+
+        A      +a+
+++++++++++++++++++
