+++++++++++++++++++++++++++++++++++++++++++++++++
+                                               +
+                                               +
+                                               +
+                                               +
+                                               +
+                                               +
+                                               +
+                                               +
+                                               +
+                                               +
+                                               +
+                                               +
+                                               +
+                                               +
+                                               +
+                                               +
+                                               +
+                                               +
+                                               +
+                                               +
+                                               +
+                                               +
+                       a                       +
+                       A                       +
+                                               +
+                                               +
+                                               +
+                                               +
+                                               +
+                                               +
+                                               +
+                                               +
+                                               +
+                                               +
+                                               +
+                                               +
+                                               +
+                                               +
+                                               +
+                                               +
+                                               +
+                                               +
+                                               +
+                                               +
+                                               +
+                                               +
+                       0                       +
+++++++++++++++++++++++++++++++++++++++++++++++++    
  
          