++++++++++++++++++++++++++++
+             0        Aa  +
+                      Bb  +
+ +++++++++++++++++        +
+                          +
++++++++++++++++++++++++++++
