+++++++++++++++++++++++++++
+            +        y   +
+ ++++ +++++ + +++++ ++++ +
+ +  + +   + + +   + +  + +
+ ++++ +++++ + +++++ ++++ +
+  e                      +
+ ++++ ++ +++++++ ++ ++++ +
+ ++++ ++ +++++++ ++ ++++ +
+      ++    +    ++      +
++++++ +++++ + +++++ ++++++
     + +++++ + +++++ +
     + ++         ++d+
     + ++ +++ +++ ++ +
++++++ ++ +     + ++ ++++++
+   a     +     +         +
++++++ ++ +  0  + ++ ++++++
     + ++ +++++++ ++ +
     + ++  READY  ++ +
     + ++         ++ +
++++++ ++ +++++++ ++ ++++++
+            +            +
+ ++++ +++++ + +++++ ++++ +
+ ++++ +++++ + +++++ ++++ +
+   ++               ++   +
+++ ++ ++ +++++++ ++ ++ +++
+++ ++ ++ +++++++ ++ ++ +++
+      ++    +    ++      +
+ ++++++++++ + ++++++++++ +
+ ++++++++++ + ++++++++++ +
+    r                    +
+++++++++++++++++++++++++++
