++++++++++++
+       0+a+
+ ++++++++A+
+          +
+ ++++++++ +
+B+b       +
++++++++++++
