red: 0, A
++++++++++++++++++++++++
+0A                   a+
+ A                   a+
+ A                   a+
+ A                   a+
+ A                   a+
+ A                   a+
+ A                   a+
+ A                   a+
+ A                   a+
+ A                   a+
+ A                   a+
+ A                   a+
+ A                   a+
+ A                   a+
+ A                   a+
+ A                   a+
+ A                   a+
+ A                   a+
+ A                   a+
+ A                   a+
+ A                   a+
+ A                   a+
++++++++++++++++++++++++
