++++++++++++
+0A       a+
+          +
+1B        +
+          +
+          +
+          +
+          +
+          +
+          +
+         b+
++++++++++++
