                   +++++++++
                   +D  defg+
++++++++++++++++++++       +
+   C  +     +mno  +   E   + 
+ A    +     +     +       +
+      +     +     +F      +
+   B  +     +     +       +
+                  +      G+
+++++++++O+ +++++++++  +++ +
+        N+          KL +  +
+        M+     I       +  +
+                   0   +  +
+            J          +  +
+         +             +c +
+         +      H      +b +
+hijkl    +             +a +
++++++++++++++++++++++++++++
