red: 0,A
green: 1,B
cyan: 2,C
+++++++++++++++++++++
+0    +         1   +
+ + + + +++++++ + + +
+ a B +   c   + A b +
+ + + +++++++ + + + +
+             +2    +
+++ +++++++++++++ +++
+++       C       +++
+++++++++++++++++++++
                