red: 0,A,B,C,D,E,F,G,H,I,J
blue: 1,O,P,Q,R,S,T,U,V,X,Y
+++++++++++++++++++++++++++++++++++++++++++++++++++++++++++++++++++++++
+JJ           B              D     +                          Q R     +
+JJ             C    I          B  +                          U V     +
+          J                       +                          X Y     +
+                   J   E       B  +                          S T     +
+      H                   A0B     +                          O1P     +
+         A     I                  +                                  +
+                    G  C  I    A  +                                  +
+                  J               +                                  +
+                      A    E   D  +                                  +
+     F                        DDD +                                  +
+                               D  +                                  +
+                   H   I    J  E  +                                  +
+ A        F                       +                                  +
+ A                    G  B   C    +                                  +
+++a++++++++++++++++++++++++++++++++++o++++++++++++++++++++++++++++++++
  +b+                                +p+
  +c+                                +q+
  +d+                                +r+
  +e+                                +s+
  +f+                                +t+
  +g+                                +u+
  +h+                                +v+
  +i+                                +x+
  +j+                                +y+
  +++                                +++
