blue: 0,A,B
red: 1,C
+++++++++++++++++++++++
+            +       A+
+          0 +        +
+          1 +        +
+            +       B+
+  +++++++++++ ++++++++
+         C           +
+                     +
+       a c+ b        +
+                     +
+                     +
+++++++++++++++++++++++
