+++++++++++
+         +
+ +++ +++ +
+ +C+E+G+ +
+ +d+f+h+ +
+a+A 0 B+b+
+ +c+e+g+ +
+ +D+F+H+ +
+ +++ +++ +
+         +
+++++++++++