      +++   +++++++ +++++++     +++      +++      +++
     +  D+    +a+   +          +   +     +e +    +  +
    +  +  +   +B+   + ++      +  +  +    +   +  +   +
   + A+++  +  + +   +        + c+++  +   +    ++    +
  +  +   +  + + +   +++++++ +  +   +  +  +  +  C +  +
 +  +++++++  ++ ++++++++++++  +++++++  +++  ++  ++  +
+E         0         d                             b+
+++++++++++++++++++++++++++++++++++++++++++++++++++++
