blue: 0,A,B,C,D,E,F,G
+++++++++++++++++++++++++++++++++++
+             ABC DEF            0+
+                                 +
+             G  G  G             +
+                                 +
+             G  G  G             +
+                                 +
+             G  G  G             +
+                                 +
+             G  G  G             +
+                                 +
+++++++++++++++++ +++++++++++++++++
+++++++++++++++++d+++++++++++++++++
+++++++++++++++++c+++++++++++++++++
+++++++++++++++++e+++++++++++++++++
+++++++++++++++++b+++++++++++++++++
+++++++++++++++++f+++++++++++++++++
+++++++++++++++++a+++++++++++++++++
+++++++++++++++++++++++++++++++++++
