       +++++++++     +++++++++       
       + I     +     +       +       
       +       +     +    J  +       
       ++++ ++++     ++++ ++++       
          + +           + +          
          + +  +++++++  + +          
          + +  +     +  + +          
          + +  +     +  + +          
          + +  +    D+  + +          
+++++++   + +  +++ +++  + +   +++++++
+     +   + +    + +    + +   +   G +
+     +++++ ++++++ ++++++ +++++     +
+   H            + +                +
+     ++++++++++ + + ++++++++++     +
+     +        + + + +        +     +
+++++++        +l+ +k+        +++++++
               + f e +               
+++++++        +++ +++        +++++++
+ B   +          + +          +     +
+     ++++++++++++c++++++++++++   0 +
+                a b                +
+     ++++++++++++d++++++++++++     +
+     +          + +          + A   +
+++++++        +++ +++        +++++++
               + g h +               
+++++++        +j+ +i+        +++++++
+     +        + + + +        +     +
+     ++++++++++ + + ++++++++++   F +
+                + +                +
+  E  +++++ ++++++ ++++++ +++++     +
+     +   + +    + +    + +   +     +
+++++++   + +  +++ +++  + +   +++++++
          + +  +     +  + +          
          + +  +     +  + +          
          + +  +C    +  + +          
          + +  +++++++  + +          
          + +           + +          
       ++++ ++++     ++++ ++++       
       +  K    +     +       +       
       +       +     +    L  +       
       +++++++++     +++++++++        