++++++++++++++++
+CaAADAAAEBa   +
+++++++++++    +
+              +
+  +++++++++   +
+  a   +ce++ +0+
++++++ +ad++ +A+
+ aa   +     +b+
++++++++++++++++
