++++++++++++++++++++++++++++++++++++++++++++++++++++++++++++++++++++++++++
+                                                                        +
+     0123456789                                                         +
+                                                                        +
+                                                                        +
+       aaaaaaaaaaaaaaaaaaaaaaaaaaaaaaaaaaaaaaaaaaaaaaaaaaaaaaaaaaaa     +
+                                                                        +
+                                                                        +
+                                                                        +
+                                                                        +
+                                                                        +
+                                                                        +
+                                                                        +
+                                                                        +
+                                                                        +
+                                                                        +
+                                                                        +
+                                                                        +
+                                                                        +
+        ++++++++++++++++                                                +
+                                           +                            +
+                                                                        +
+                                                                        +
+                                                                        +
+                                                                        +
+                                                                        +
+                                                                        +
+                                                                        +
+                                                                        +
+                                                                        +
+             +                  +                                       +
+                                                                        +
+                                                                        +
+                                                                        +
+                                                                        +
+                                                                        +
+                                                                        +
+                                                                        +
+                                                                        +
+                                                                        +
+                                                                        +
+                                                                        +
+                                                                        +
+                                                                        +
+                                                                        +
+                                                                        +
+                                                                        +
+                                                      +                 +
+                                                                        +
+                                                                        +
+                                                                        +
+                                           +                            +
+                           ++++++++++++                                 +
+                                                                        +
+          +                                                             +
+                                                                        +
+                                                                        +
+                                                                        +
+                                                                        +
+       AAAAAAAAAAAAAAAAAAAAAAAAAAAAAAAAAAAAAAAAAAAAAAAAAAAAAAAAAAAA     +
+                                                                        +
+                                                                        +
+                                                                        +
+                                                                        +
+                                                                        +
+                                                                        +
+                                                                        +
+                                                                        +
+                                                                        +
+                                                                        +
+                                                                        +
++++++++++++++++++++++++++++++++++++++++++++++++++++++++++++++++++++++++++
