++++++++++++
+0      B+A+
+ ++++++++a+
+          +
+ ++++++++C+
+b+c       +
++++++++++++
