red: 0,A,B,C,D,E,F
blue: 2,3,X,Y,Z
green: 1,K,J,M,N
+++++++++                  ++++++++
+abcd   +                  + f    +
+DCBA   +                  +      +
+ 0     ++++++++++++++++++++     F+
+        e           A          E1+
+++ +++++++++++++++++++++++++++++++
  +a+ 32 j + xyz    ZX            +
  + ++++++J++++++++++Y+++++++++++++
  +K x            +     d m  n    +
++++++++++X       +     e+++++++  +
+yy++++++YY       +     f       Fk+
+  DE            NM               +
+++++++++++++++++++++++++++++++++++
