red: 0,A
green: 1,B
magenta: 2,C
cyan: 3,D,E
orange: 4,5,F,G,H
pink: 6,7,8
+++++++++++
+ 0A    Aa+
+ 1B    Bb+
+ 2C    Bc+
+ 3D    Dd+
+  E    Ee+
+ 4FF   Ff+
+ 5GG   Gg+
+  H H  Hh+
+ 8      H+
+ 7      h+
+ 6      h+
+++++++++++
