red:1,A
green:2,B
blue:3,D
cyan:0,C
+++++++++++
+++c+++   +
+b+ +a+ + +
+A2C1B  + +
+++ +++ +d+
++ 0 ++ +++
+++++++ +++
+3D     +++
+++++++++++
