red: 0,A
green: 1,B
blue: 2,C 
++++++++++++
+0         +
++++++++ +++
+        +a+
+ ++++++++A+
+  bc      +
+++++  +++ +
++++++++++ +
+1  B  2 C +
++++++++++++
