red: 0,A,B,C,D,G
green: 1,E,F
++++++++++++++++++++++
+       0+a       b  +
+ ++++++++A + +B++++++
+c                  C+
+        dG +  e +++ +
+D++++++++     + +  E+
+g+1           Ff    +
++++++++++++++++++++++
