red: 0,A,B,C,D,E,F,G,I,J
blue: 1,H
cyan: 2,W,K
magenta: 3,O
+++++++++++
+++f+++++++
+++F+++++++
+kKfWw+++++
+34 +++++++
++o  2+++++
++F +++++++
+++ +++++++
+ 0      1+
+J+ +b+H+h+
+I+F+d+H+h+
+H+f+f+J+j+
+G+++h+H+h+
+F+++j+H+h+
+E+++i+H+h+
+D+++g+H+h+
+C+++e+H+h+
+B+++c+H+h+
+A+++a+++O+
+++++++++O+
+++++++++++
