++++   ++++
+ 0+   +  +
+ A+++++  +
+       aa+
+ A+++++  +
+ 1+   +  +
++++   ++++
